NO ./textures/texture_n.xpm
SO ./textures/texture_s.xpm
WE ./textures/texture_w.xpm
EA ./textures/texture_e.xpm

F 220,100,0
C 225,30,0

        1111111111111111111111111     11111111111111111111111111111111111111
        1000000000110000000000001     10000000000000000000000000000000000001
        1011000001110000000000001     10000000000000000000000000000000000001
        1001000000000000000000001     10000000000000000000000000000000000001
1111111110110000011100000000000011111110000000000000000000000000000000000001
1000000000000000000000000000000000000000000000000000000000000000000000000001
1000000000000000000000000000000011111111111111111111111111111111111111111111
1000000000110000011101111111111110000000000000000000000000000000000000000001
1111011111111101110000001000000000000000000000000000000000000000000000000001
1111011111111101110101001000101010101010101010101010101010101010101010101001
1100000011010101110000001000000000000000000000000000000000000000000000000001
1000000000000000110000001000000000000000000000000000000000000000000011111111
1000000000000000110101001000000000000000000000000000000000000000011111111111
11000001110101011111011110W000000000000000000000000000000000000111
11110111 1110101 10111101000000000000000000000000000000000000001
11111111 1111111 1111111111111111111111111111111111111111111111111
