NO ./textures/texture_1.xpm
SO ./textures/texture_2.xpm
WE ./textures/texture_3.xpm
EA ./textures/texture_4.xpm

F 220,100,0
C 225,30,0

111111
100101
101001
110S01
111111
