NO ./textures/texture_n.xpm
SO ./textures/texture_s.xpm
WE ./textures/texture_w.xpm
EA ./textures/texture_e.xpm

F 220,100,0
C 225,30,0

111111
100101
101001
1100E1
11111
