NO ./textures/texture_n.xpm
SO ./textures/texture_s.xpm
WE ./textures/texture_w.xpm
EA ./textures/texture_e.xpm

F 220,100,255
C 225,30,255

111111111111111111111111111111
100000000000000000000000000001
100001000000111111111111111111
1000000N000001
10000000000001
1000000011111
100000001
1111111
