NO imgs/xpm/wall/default_junglewood.xpm
SO imgs/xpm/wall/default_junglewood.xpm
WE imgs/xpm/wall/default_junglewood.xpm
EA imgs/xpm/wall/default_junglewood.xpm

C 37,37,37
F 110,110,110

KEY 674,1239
KEY 614,98
KEY 621,420
KEY 794,1744
KEY 736,878
KEY 47,1068

     11111111
     10000201
     11110121
     10013101
     10010111
     10012101
     10110101
     10020101
     10011101
     10000001
     10000001
     10000001
     10000001
     10000001
     10003001111111
     10000000000001
     10000000W00001
     10000300000001
     11100000000001
     10000000000001
     10011000111111
  111100000001
  100000110001
  100000100001
  101111100001
  101000100001
  101011100001
  101210000001
  100000001001
  111111111111
