NO ./textures/texture_n.xpm
SO ./textures/texture_s.xpm
WE ./textures/texture_w.xpm
EA ./textures/texture_e.xpm

F 220,100,0
C 225,30,0

111111111111111111111111111111
1000000000000S0000000000000001
100001000000111111111111111111
1000000N000       00        1
10000000000                001
1000000         011       111
100000      001
111111                111
