NO ../../textures/n_wall.xpm
SO ../../textures/s_wall.xpm
WE ../../textures/w_wall.xpm
EA ../../textures/e_wall.xpm

F 220,100,0
C 225,30,0

        1111111111111111111111111
        100000 000110000000000001
        101100 001110000000000001
        100100 000000000000000001
11111111101100 001110000000000001
10000000001100 001110111111111111
11110111111111 11100000010001
11110111111111 11101010010001
11000000110101 11100000010001
10000000000000 01100000010001
10000000000000 01101010010001
11000001110101 11111011110N0111
11110111 11101 1 101111010001
11111111 1111111 111111111111


