NO ./textures/texture_n.xpm
SO ./textures/texture_s.xpm
WE ./textures/texture_w.xpm
EA ./textures/texture_e.xpm


F 22,22,22

C 14,0,32

11111111
11111111
