NO ./textures/texture_n.xpm
SO ./textures/texture_s.xpm
WE ./textures/texture_w.xpm
EA ./textures/texture_e.xpm

F 255,0,0
C 0,0,255


11111111111
10000E00031
10000000001
10000000021
10000000001
10000000001
10001010001
10001210001
10001010001
10001210001
10001210001
10000000001
10000010001
10000020001
10000010001
10000000001
10000000001
10000000011
1000000001
10000000011
10000000001
10000000001
10000000001
10000000001
10000000001
10000000001
10000000001
10000000001
10000000001
10000010101
10000000001
10000000001
10000000001
10000000001
10000000001
10000000001
11111111111
