NO     ./textures/texture_n.xpm
SO    ./textures/texture_s.xpm
WE ./textures/texture_w.xpm
EA ./textures/texture_e.xpm


F 22,22,22

C 14,0,32

11111111
10000001
10011001
10000001
1000N001
10011001
11111111
